#####
#@$.#
#####
;
 ########
##      #
#   .   #
#   $   #
# .$@$. #
####$   #
   #.   #
   #   ##
   ##### 
;
############
#          #
#         .#
# @   $#$  #
#          #
#         .#
#          #
############
;
############
#      #   #
#@     #  .#
#  # # #   #
#  # #  $$.#
#  #$#     #
#         .#
############
;
  #####     
##.$ ##     
#...  #     
#$.$  #     
# $   #     
#@$   #     
#  ####     
###         
;
#####        
##  #        
##  #        
## .###      
## $$ #      
## .# #      
##  @ #      
#######                  
;
#####       
##  #       
# @$#       
##$ ##      
#  $ #      
# $  #      
#....#      
######      
;
########    
#      ##   
# $#$$ .#   
#@ # # .#   
#  # # .#   
#  $   .#   
#     ###   
#######    
; 
########    
#@  #  #    
# #$   #    
#      #    
# . $$.#    
##$#.# #    
 #  .  #    
 #######                     
